5 5 5 1
1 1 1 0
3 1 1 0
1 1 1 1 1
1 1 1 1 1
1 1 1 1 1
1 1 1 1 1
1 1 1 1 1
1 1 1 1 1
1 0 1 0 1
1 1 1 1 1
1 0 0 0 1
1 1 1 1 1
1 1 1 1 1
1 0 1 0 1
1 1 1 1 1
1 0 1 0 1
1 1 1 1 1
1 1 1 1 1
1 0 1 0 1
1 0 1 0 1
1 0 1 0 1
1 1 1 1 1
1 1 1 1 1
1 1 1 1 1
1 1 1 1 1
1 1 1 1 1
1 1 1 1 1
1
1 3 3 0
Press Q to release a spirit. Spirit can move through wall. Press again to return.