5 5 5 5
1 1 1 1
3 3 3 3
1 1 1 1 1 (z = 0) (w = 0)
1 1 1 1 1
1 1 1 1 1
1 1 1 1 1
1 1 1 1 1
1 1 1 1 1 (z = 1)
1 1 1 1 1
1 1 1 1 1
1 1 1 1 1
1 1 1 1 1
1 1 1 1 1 (z = 2)
1 1 1 1 1
1 1 1 1 1
1 1 1 1 1
1 1 1 1 1
1 1 1 1 1 (z = 3)
1 1 1 1 1
1 1 1 1 1
1 1 1 1 1
1 1 1 1 1
1 1 1 1 1 (z = 4)
1 1 1 1 1
1 1 1 1 1
1 1 1 1 1
1 1 1 1 1
1 1 1 1 1 (z = 0) (w = 1)
1 1 1 1 1
1 1 1 1 1
1 1 1 1 1
1 1 1 1 1
1 1 1 1 1 (z = 1)
1 0 0 0 1
1 1 1 1 1
1 0 0 0 1
1 1 1 1 1
1 1 1 1 1 (z = 2)
1 0 1 1 1
1 1 1 1 1
1 1 1 1 1
1 1 1 1 1
1 1 1 1 1 (z = 3)
1 0 1 0 1
1 1 1 1 1
1 1 1 1 1
1 1 1 1 1
1 1 1 1 1 (z = 4)
1 1 1 1 1
1 1 1 1 1
1 1 1 1 1
1 1 1 1 1
1 1 1 1 1 (z = 0) (w = 2)
1 1 1 1 1
1 1 1 1 1
1 1 1 1 1
1 1 1 1 1
1 1 1 1 1 (z = 1)
1 1 1 0 1
1 1 1 1 1
1 0 1 0 1
1 1 1 1 1
1 1 1 1 1 (z = 2)
1 1 1 0 1
1 1 1 1 1
1 0 1 1 1
1 1 1 1 1
1 1 1 1 1 (z = 3)
1 0 1 0 1
1 0 1 1 1
1 0 1 0 1
1 1 1 1 1
1 1 1 1 1 (z = 4)
1 1 1 1 1
1 1 1 1 1
1 1 1 1 1
1 1 1 1 1
1 1 1 1 1 (z = 0) (w = 3)
1 1 1 1 1
1 1 1 1 1
1 1 1 1 1
1 1 1 1 1
1 1 1 1 1 (z = 1)
1 0 1 0 1
1 0 1 1 1
1 0 1 0 1
1 1 1 1 1
1 1 1 1 1 (z = 2)
1 1 1 1 1
1 1 1 1 1
1 1 1 0 1
1 1 1 1 1
1 1 1 1 1 (z = 3)
1 1 1 1 1
1 1 1 1 1
1 1 1 0 1
1 1 1 1 1
1 1 1 1 1 (z = 4)
1 1 1 1 1
1 1 1 1 1
1 1 1 1 1
1 1 1 1 1
1 1 1 1 1 (z = 0) (w = 4)
1 1 1 1 1
1 1 1 1 1
1 1 1 1 1
1 1 1 1 1
1 1 1 1 1 (z = 1)
1 1 1 1 1
1 1 1 1 1
1 1 1 1 1
1 1 1 1 1
1 1 1 1 1 (z = 2)
1 1 1 1 1
1 1 1 1 1
1 1 1 1 1
1 1 1 1 1
1 1 1 1 1 (z = 3)
1 1 1 1 1
1 1 1 1 1
1 1 1 1 1
1 1 1 1 1
1 1 1 1 1 (z = 4)
1 1 1 1 1
1 1 1 1 1
1 1 1 1 1
1 1 1 1 1
0