5 5 5 4
1 1 1 1
3 1 1 1
1 1 1 1 1 (z = 0) (w = 0)
1 1 1 1 1
1 1 1 1 1
1 1 1 1 1
1 1 1 1 1
1 1 1 1 1 (z = 1)
1 1 1 1 1
1 1 1 1 1
1 1 1 1 1
1 1 1 1 1
1 1 1 1 1 (z = 2)
1 1 1 1 1
1 1 1 1 1
1 1 1 1 1
1 1 1 1 1
1 1 1 1 1 (z = 3)
1 1 1 1 1
1 1 1 1 1
1 1 1 1 1
1 1 1 1 1
1 1 1 1 1 (z = 4)
1 1 1 1 1
1 1 1 1 1
1 1 1 1 1
1 1 1 1 1
1 1 1 1 1 (z = 0) (w = 1)
1 1 1 1 1
1 1 1 1 1
1 1 1 1 1
1 1 1 1 1
1 1 1 1 1 (z = 1)
1 0 1 0 1
1 1 1 1 1
1 0 0 0 1
1 1 1 1 1
1 1 1 1 1 (z = 2)
1 1 1 1 1
1 1 1 1 1
1 1 1 1 1
1 1 1 1 1
1 1 1 1 1 (z = 3)
1 0 1 0 1
1 0 1 0 1
1 0 1 0 1
1 1 1 1 1
1 1 1 1 1 (z = 4)
1 1 1 1 1
1 1 1 1 1
1 1 1 1 1
1 1 1 1 1
1 1 1 1 1 (z = 0) (w = 2)
1 1 1 1 1
1 1 1 1 1
1 1 1 1 1
1 1 1 1 1
1 1 1 1 1 (z = 1)
1 0 1 0 1
1 1 1 1 1
1 0 1 0 1
1 1 1 1 1
1 1 1 1 1 (z = 2)
1 0 1 0 1
1 1 1 1 1
1 0 1 0 1
1 1 1 1 1
1 1 1 1 1 (z = 3)
1 0 1 0 1
1 1 1 1 1
1 0 1 0 1
1 1 1 1 1
1 1 1 1 1 (z = 4)
1 1 1 1 1
1 1 1 1 1
1 1 1 1 1
1 1 1 1 1
1 1 1 1 1 (z = 0) (w = 3)
1 1 1 1 1
1 1 1 1 1
1 1 1 1 1
1 1 1 1 1
1 1 1 1 1 (z = 1)
1 1 1 1 1
1 1 1 1 1
1 1 1 1 1
1 1 1 1 1
1 1 1 1 1 (z = 2)
1 1 1 1 1
1 1 1 1 1
1 1 1 1 1
1 1 1 1 1
1 1 1 1 1 (z = 3)
1 1 1 1 1
1 1 1 1 1
1 1 1 1 1
1 1 1 1 1
1 1 1 1 1 (z = 4)
1 1 1 1 1
1 1 1 1 1
1 1 1 1 1
1 1 1 1 1
1
1 1 3 2
Spirit of course can move freely about time because even if there will be or was a wall, spirit will not be stopped by it.