7 7 7 1
1 1 1 0
5 5 5 0
1 1 1 1 1 1 1 (z=0)
1 1 1 1 1 1 1
1 1 1 1 1 1 1
1 1 1 1 1 1 1
1 1 1 1 1 1 1
1 1 1 1 1 1 1
1 1 1 1 1 1 1
1 1 1 1 1 1 1 (z=1)
1 0 0 0 0 0 1
1 1 1 1 1 0 1
1 0 1 0 1 0 1
1 0 1 0 1 1 1
1 0 1 0 0 0 1
1 1 1 1 1 1 1
1 1 1 1 1 1 1 (z=2)
1 0 1 1 1 1 1
1 1 1 1 1 1 1
1 0 1 0 1 0 1
1 1 1 1 1 1 1
1 0 1 1 1 0 1
1 1 1 1 1 1 1
1 1 1 1 1 1 1 (z=3)
1 0 0 0 1 0 1
1 1 1 1 1 0 1
1 0 0 0 1 0 1
1 0 1 1 1 1 1
1 0 1 0 1 0 1
1 1 1 1 1 1 1
1 1 1 1 1 1 1 (z=4)
1 1 1 0 1 0 1
1 1 1 1 1 1 1
1 1 1 0 1 1 1
1 1 1 1 1 1 1
1 0 1 0 1 0 1
1 1 1 1 1 1 1
1 1 1 1 1 1 1 (z=5)
1 0 0 0 1 0 1
1 0 1 1 1 0 1
1 0 1 0 0 0 1
1 0 1 0 1 1 1
1 0 1 0 1 0 1
1 1 1 1 1 1 1
1 1 1 1 1 1 1 (z=6)
1 1 1 1 1 1 1
1 1 1 1 1 1 1
1 1 1 1 1 1 1
1 1 1 1 1 1 1
1 1 1 1 1 1 1
1 1 1 1 1 1 1
1
1 1 1 0
Last level in 3D. Good luck.